20 20
0 0
3 7 7 7 7 7 7 7 7 7 7 7 7 7 7 7 7 7 7 4
6 0 0 0 0 0 0 0 0 0 0 0 0 0 0 0 0 0 0 8
6 0 0 0 0 0 0 0 0 0 0 0 0 0 0 0 0 0 0 8
6 0 0 0 0 0 0 0 0 0 0 0 0 0 0 0 0 0 0 8
6 0 0 0 0 0 0 0 0 0 0 0 0 0 0 0 0 0 0 8
6 0 0 0 0 0 0 0 0 0 0 0 0 0 0 0 0 0 0 8
6 0 0 0 0 0 0 0 0 0 0 0 0 0 0 0 0 0 0 8
6 0 0 0 0 0 0 0 0 0 0 0 0 0 0 0 0 0 0 8
6 0 0 0 0 0 0 0 0 0 0 0 0 0 0 0 0 0 0 8
6 0 0 0 0 0 0 0 0 0 0 0 0 0 0 0 0 0 0 8
6 0 0 0 0 0 0 0 0 0 0 0 0 0 0 0 0 0 0 8
6 0 0 0 0 0 0 0 0 0 0 0 0 0 0 0 0 0 0 8
6 0 0 0 0 0 0 0 0 0 0 0 0 0 0 0 0 0 0 8
6 0 0 0 0 0 0 0 0 0 0 0 0 0 0 0 0 0 0 8
6 0 0 0 0 0 0 0 0 0 0 0 0 0 0 0 0 0 0 8
6 0 0 0 0 0 0 0 0 0 0 0 0 0 0 0 0 0 0 8
6 0 0 0 0 0 0 0 0 0 0 0 0 0 0 0 0 0 0 8
6 0 0 0 0 0 0 0 0 0 0 0 0 0 0 0 0 0 0 8
6 0 0 0 0 0 0 0 0 0 0 0 0 0 0 0 0 0 0 8 
1 5 5 5 5 5 5 5 5 5 5 5 5 5 5 5 5 5 5 2